[
  {
    "Name": "LEVEL 1",
    "Heights": [
      1, 3, 4, 5, 7, 9, 12, 12, 12, 15, 17, 19, 21, 22, 20, 20, 20, 28, 36, 37,
      38, 38, 36, 36, 20, 21, 18, 16, 12, 11, 11, 8, 8, 5, 5, 1, 2, 12, 14, 21,
      23, 34, 35, 34, 34, 34, 36, 38, 45, 51, 50, 52, 52, 49, 49, 35, 29, 23,
      18, 18, 23, 23, 20, 18, 14, 12, 10, 6, 5, 5, 4, 3, 2, 1, 2, 3, 1, 1, 1, 1,
      1
    ],
    "Vertical_Stretch": 80,
    "Horizontal_Stretch": 100,
    "POIS": [
      [2, 5],
      [5, 3]
    ]
  },
  {
    "Name": "LEVEL 2",
    "Heights": [
      1, 3, 4, 5, 7, 9, 12, 12, 12, 15, 17, 19, 21, 22, 20, 20, 20, 28, 36, 37,
      38, 38, 36, 36, 20, 21, 18, 16, 12, 11, 11, 8, 8, 5, 5, 1, 2, 12, 14, 21,
      23, 34, 35, 34, 34, 34, 36, 38, 45, 51, 50, 52, 52, 49, 49, 35, 29, 23,
      18, 18, 23, 23, 20, 18, 14, 12, 10, 6, 5, 5, 4, 3, 2, 1, 2, 3, 1, 1, 1, 1,
      1
    ],
    "Vertical_Stretch": 80,
    "Horizontal_Stretch": 150,
    "POIS": [
      [2, 5],
      [5, 3]
    ]
  }
]
